WWWWWWWWWWW
WKWKWKWKWKW
WKWWWKKKWKW
WKKKWWWKWKW
WWWWWWWKKKW
WWWKKKKKWKW
WWWKWWWWKKW
WWWWWWWWWWW