WRGBWWWWWWW
WKWKWKWKWKW
WKWWWKKKWKW
WKKKWWWKWKW
WWWWWGWKKKW
WWWKKKKKWKW
WWWKWWWWKKW
WWWWBWWWWWW