WWWWWWWWWWWWWWWWWWWWWWWWWWWWWWWW
W------------------------------W
WWWWWWWWWWWWWWWWWWWWWWWWWWWWW--W
W----R---r---------------------W
W--WWWWWWWWWWWWWWWWWWWWWWWWWWWWW
W------------------------------W
W------------------------------W
W-------I---------I--------I---W
W--WWWWWWWWWWWWWWWWWWWWWWWWWWWWW
W---I--------------------------W
WWWWWWWWWWWWWWWWWWWWWWWWWWWWWWWW
W------------------------------W
W------------------------------W
W------------------------------W
W------------------------------W
W------------------------------W
W------------------------------W
WWWWWWWWWWWWWWWWWWWWWWWWWWWWWWWW