WWWWWWWWWWWWWWWWWWWWWWWWWWWWWWWW
W------------------------------W
WWWWWWWWWWWWWWWWWWWWWWWWWWWWW--W
W----R---r---------------------W
WWWWWWWWWWWWWWWWWWWWWWWWWWWWWWWW
W------------------------------W
W------------------------------W
W------------------------------W
W------------------------------W
W------------------------------W
W------------------------------W
W------------------------------W
W------------------------------W
W------------------------------W
W------------------------------W
W------------------------------W
W------------------------------W
WWWWWWWWWWWWWWWWWWWWWWWWWWWWWWWW