WWWWWWWWWWWWWWWWWWWWWWWWWWWWWWWW
W------G-W----W-W-WWW--------r-W
W-----bW-W----W-----B---WGWWWWRW
W-WWWWWW-W-WW---W-W-WI--W----g-W
W-Wg-----WbWW-W-W-W-WWbWWRWWWWWW
W-W-WWWWWWWWWWWWWWW-WWWW---WWWWW
WIW-W-------------W-WW-B-W-W--bW
W-W-WWW-WbbrgbrgrbWrW-IWWW-B---W
W-W-WWW-WBBRGGGRgGW-W-WWWW--WW-W
WBW-G-W-WGGRRbGrBrW-WWW-WWW-WWGW
W---R-W-WbgGGBrRBEW-------W--W-W
WGGRG-W-WBrRGgBBbRWWWWWWW-WW-W-W
W-W---W-WBBrBBGrRGGrRRb-W--W-R-W
W-WWWWW-WGGRRgGBRgWWWWW-W-WW-W-W
W-WW----WRbBGRRGbrW---W-W-W--W-W
W-WW----WgGGBbrBBrW-I-R-W-W-W--W
W-------WBGRrBBgGGW---W---WWWg-W
WWWWWWWWWWWWWWWWWWWWWWWWWWWWWWWW